11111111111111111111111111111111
10000000000001000010000000000001
10111101111101000010111110111101
10100101000101100110100010100101
10111101111100000000111110111101
10000000000000100100000000000001
10000000000000011000000000000001
10111101000111111111100010111101
10000001000011111111000010000001
11111101111000111100011110111111
10000101000010011001000010100001
11111101000011000011000010111111
10000000000000000000000000000001
11111101011111111111111010111111
10000101011111111111111010100001
11111101000000011000000010111111
10000000000000011000000000000001
10111101111110011001111110111101
10000100000000000000000000100001
10000001000100100100100010000001
10110001000100011000100010001101
10000111111111011011111111100001
11100000000000000000000000000111
11111111111111111111111111111111